Groups Coverage Summary
Total groups in report: 147
+---------+----------+-----------------------------+
|  SCORE  |  WEIGHT  |            NAME             |
+=========+==========+=============================+
|  18.75  |    1     |          opcode_cg          |
+---------+----------+-----------------------------+
| 30.2083 |    1     |          csrrw_cg           |
+---------+----------+-----------------------------+
|   60    |    1     |        rv32i_misc_cg        |
+---------+----------+-----------------------------+
|   50    |    1     |      mepc_alignment_cg      |
+---------+----------+-----------------------------+
| 35.1562 |    1     |           beq_cg            |
+---------+----------+-----------------------------+
|    0    |    1     |           jal_cg            |
+---------+----------+-----------------------------+
| 26.0417 |    1     |           lui_cg            |
+---------+----------+-----------------------------+
|   50    |    1     |           addi_cg           |
+---------+----------+-----------------------------+
| 26.0417 |    1     |          auipc_cg           |
+---------+----------+-----------------------------+
| 47.2656 |    1     |           ori_cg            |
+---------+----------+-----------------------------+
| 47.2656 |    1     |           add_cg            |
+---------+----------+-----------------------------+
| 48.0469 |    1     |           sub_cg            |
+---------+----------+-----------------------------+
| 30.4688 |    1     |           sra_cg            |
+---------+----------+-----------------------------+
| 39.4531 |    1     |           andi_cg           |
+---------+----------+-----------------------------+
| 28.125  |    1     |           srli_cg           |
+---------+----------+-----------------------------+
| 30.9028 |    1     |           and_cg            |
+---------+----------+-----------------------------+
| 32.4219 |    1     |           srl_cg            |
+---------+----------+-----------------------------+
| 32.0312 |    1     |           sll_cg            |
+---------+----------+-----------------------------+
| 29.1667 |    1     |           xor_cg            |
+---------+----------+-----------------------------+
| 29.5139 |    1     |            or_cg            |
+---------+----------+-----------------------------+
| 30.0781 |    1     |           sltu_cg           |
+---------+----------+-----------------------------+
| 42.8571 |    1     |          sltiu_cg           |
+---------+----------+-----------------------------+
| 39.8438 |    1     |           xori_cg           |
+---------+----------+-----------------------------+
| 43.3036 |    1     |           slti_cg           |
+---------+----------+-----------------------------+
|  31.25  |    1     |           srai_cg           |
+---------+----------+-----------------------------+
| 32.8125 |    1     |           slt_cg            |
+---------+----------+-----------------------------+
| 33.125  |    1     |           slli_cg           |
+---------+----------+-----------------------------+
|    0    |    1     |           mul_cg            |
+---------+----------+-----------------------------+
|    0    |    1     |           mulh_cg           |
+---------+----------+-----------------------------+
|    0    |    1     |          mulhsu_cg          |
+---------+----------+-----------------------------+
|    0    |    1     |          mulhu_cg           |
+---------+----------+-----------------------------+
|    0    |    1     |           div_cg            |
+---------+----------+-----------------------------+
|    0    |    1     |           divu_cg           |
+---------+----------+-----------------------------+
|    0    |    1     |           rem_cg            |
+---------+----------+-----------------------------+
|    0    |    1     |           remu_cg           |
+---------+----------+-----------------------------+
|    0    |    1     |           c_lw_cg           |
+---------+----------+-----------------------------+
|    0    |    1     |          c_lwsp_cg          |
+---------+----------+-----------------------------+
|    0    |    1     |           c_sw_cg           |
+---------+----------+-----------------------------+
|    0    |    1     |          c_swsp_cg          |
+---------+----------+-----------------------------+
|    0    |    1     |        c_addi4spn_cg        |
+---------+----------+-----------------------------+
|    0    |    1     |          c_addi_cg          |
+---------+----------+-----------------------------+
|    0    |    1     |        c_addi16sp_cg        |
+---------+----------+-----------------------------+
|    0    |    1     |           c_li_cg           |
+---------+----------+-----------------------------+
|    0    |    1     |          c_lui_cg           |
+---------+----------+-----------------------------+
|    0    |    1     |          c_sub_cg           |
+---------+----------+-----------------------------+
|    0    |    1     |          c_add_cg           |
+---------+----------+-----------------------------+
|    0    |    1     |           c_mv_cg           |
+---------+----------+-----------------------------+
|    0    |    1     |          c_andi_cg          |
+---------+----------+-----------------------------+
|    0    |    1     |          c_xor_cg           |
+---------+----------+-----------------------------+
|    0    |    1     |           c_or_cg           |
+---------+----------+-----------------------------+
|    0    |    1     |          c_and_cg           |
+---------+----------+-----------------------------+
|    0    |    1     |          c_beqz_cg          |
+---------+----------+-----------------------------+
|    0    |    1     |          c_bnez_cg          |
+---------+----------+-----------------------------+
|    0    |    1     |          c_srli_cg          |
+---------+----------+-----------------------------+
|    0    |    1     |          c_srai_cg          |
+---------+----------+-----------------------------+
|    0    |    1     |          c_slli_cg          |
+---------+----------+-----------------------------+
|    0    |    1     |           c_j_cg            |
+---------+----------+-----------------------------+
|    0    |    1     |          c_jal_cg           |
+---------+----------+-----------------------------+
|    0    |    1     |           c_jr_cg           |
+---------+----------+-----------------------------+
|    0    |    1     |          c_jalr_cg          |
+---------+----------+-----------------------------+
|    0    |    1     |           hint_cg           |
+---------+----------+-----------------------------+
|    0    |    1     | illegal_compressed_instr_cg |
+---------+----------+-----------------------------+
|    0    |    1     |           flw_cg            |
+---------+----------+-----------------------------+
|    0    |    1     |           fld_cg            |
+---------+----------+-----------------------------+
|    0    |    1     |           fsw_cg            |
+---------+----------+-----------------------------+
|    0    |    1     |          fadd_s_cg          |
+---------+----------+-----------------------------+
|    0    |    1     |          fadd_d_cg          |
+---------+----------+-----------------------------+
|    0    |    1     |          fsub_s_cg          |
+---------+----------+-----------------------------+
|    0    |    1     |          fsub_d_cg          |
+---------+----------+-----------------------------+
|    0    |    1     |          fmul_s_cg          |
+---------+----------+-----------------------------+
|    0    |    1     |          fmul_d_cg          |
+---------+----------+-----------------------------+
|    0    |    1     |          fdiv_s_cg          |
+---------+----------+-----------------------------+
|    0    |    1     |          fdiv_d_cg          |
+---------+----------+-----------------------------+
|    0    |    1     |         fsqrt_s_cg          |
+---------+----------+-----------------------------+
|    0    |    1     |         fsqrt_d_cg          |
+---------+----------+-----------------------------+
|    0    |    1     |          fmin_s_cg          |
+---------+----------+-----------------------------+
|    0    |    1     |          fmin_d_cg          |
+---------+----------+-----------------------------+
|    0    |    1     |          fmax_s_cg          |
+---------+----------+-----------------------------+
|    0    |    1     |          fmax_d_cg          |
+---------+----------+-----------------------------+
|    0    |    1     |         fmadd_s_cg          |
+---------+----------+-----------------------------+
|    0    |    1     |         fmadd_d_cg          |
+---------+----------+-----------------------------+
|    0    |    1     |         fnmadd_s_cg         |
+---------+----------+-----------------------------+
|    0    |    1     |         fnmadd_d_cg         |
+---------+----------+-----------------------------+
|    0    |    1     |         fmsub_s_cg          |
+---------+----------+-----------------------------+
|    0    |    1     |         fmsub_d_cg          |
+---------+----------+-----------------------------+
|    0    |    1     |         fnmsub_s_cg         |
+---------+----------+-----------------------------+
|    0    |    1     |         fnmsub_d_cg         |
+---------+----------+-----------------------------+
|    0    |    1     |         fcvt_s_d_cg         |
+---------+----------+-----------------------------+
|    0    |    1     |         fcvt_d_s_cg         |
+---------+----------+-----------------------------+
|    0    |    1     |         fcvt_w_s_cg         |
+---------+----------+-----------------------------+
|    0    |    1     |        fcvt_wu_s_cg         |
+---------+----------+-----------------------------+
|    0    |    1     |         fcvt_l_s_cg         |
+---------+----------+-----------------------------+
|    0    |    1     |        fcvt_lu_s_cg         |
+---------+----------+-----------------------------+
|    0    |    1     |         fcvt_l_d_cg         |
+---------+----------+-----------------------------+
|    0    |    1     |        fcvt_lu_d_cg         |
+---------+----------+-----------------------------+
|    0    |    1     |         fcvt_w_d_cg         |
+---------+----------+-----------------------------+
|    0    |    1     |        fcvt_wu_d_cg         |
+---------+----------+-----------------------------+
|    0    |    1     |         fcvt_s_w_cg         |
+---------+----------+-----------------------------+
|    0    |    1     |        fcvt_s_wu_cg         |
+---------+----------+-----------------------------+
|    0    |    1     |         fcvt_s_l_cg         |
+---------+----------+-----------------------------+
|    0    |    1     |         fcvt_d_l_cg         |
+---------+----------+-----------------------------+
|    0    |    1     |        fcvt_s_lu_cg         |
+---------+----------+-----------------------------+
|    0    |    1     |         fcvt_d_w_cg         |
+---------+----------+-----------------------------+
|    0    |    1     |        fcvt_d_lu_cg         |
+---------+----------+-----------------------------+
|    0    |    1     |        fcvt_d_wu_cg         |
+---------+----------+-----------------------------+
|    0    |    1     |         fsgnj_s_cg          |
+---------+----------+-----------------------------+
|    0    |    1     |         fsgnj_d_cg          |
+---------+----------+-----------------------------+
|    0    |    1     |         fsgnjn_s_cg         |
+---------+----------+-----------------------------+
|    0    |    1     |         fsgnjn_d_cg         |
+---------+----------+-----------------------------+
|    0    |    1     |         fsgnjx_s_cg         |
+---------+----------+-----------------------------+
|    0    |    1     |         fsgnjx_d_cg         |
+---------+----------+-----------------------------+
|    0    |    1     |         fmv_x_w_cg          |
+---------+----------+-----------------------------+
|    0    |    1     |         fmv_x_d_cg          |
+---------+----------+-----------------------------+
|    0    |    1     |         fmv_w_x_cg          |
+---------+----------+-----------------------------+
|    0    |    1     |         fmv_d_x_cg          |
+---------+----------+-----------------------------+
|    0    |    1     |          feq_s_cg           |
+---------+----------+-----------------------------+
|    0    |    1     |          feq_d_cg           |
+---------+----------+-----------------------------+
|    0    |    1     |          flt_s_cg           |
+---------+----------+-----------------------------+
|    0    |    1     |          flt_d_cg           |
+---------+----------+-----------------------------+
|    0    |    1     |          fle_s_cg           |
+---------+----------+-----------------------------+
|    0    |    1     |          fle_d_cg           |
+---------+----------+-----------------------------+
|    0    |    1     |         fclass_s_cg         |
+---------+----------+-----------------------------+
|    0    |    1     |         fclass_d_cg         |
+---------+----------+-----------------------------+
|    0    |    1     |           mulw_cg           |
+---------+----------+-----------------------------+
|    0    |    1     |           divw_cg           |
+---------+----------+-----------------------------+
|    0    |    1     |          divuw_cg           |
+---------+----------+-----------------------------+
|    0    |    1     |           remw_cg           |
+---------+----------+-----------------------------+
|    0    |    1     |          remuw_cg           |
+---------+----------+-----------------------------+
|    0    |    1     |         c_addiw_cg          |
+---------+----------+-----------------------------+
|    0    |    1     |          c_subw_cg          |
+---------+----------+-----------------------------+
|    0    |    1     |          c_addw_cg          |
+---------+----------+-----------------------------+
|    0    |    1     |           c_ld_cg           |
+---------+----------+-----------------------------+
|    0    |    1     |           c_sd_cg           |
+---------+----------+-----------------------------+
|    0    |    1     |          c_ldsp_cg          |
+---------+----------+-----------------------------+
|    0    |    1     |          c_sdsp_cg          |
+---------+----------+-----------------------------+
|    0    |    1     |           lwu_cg            |
+---------+----------+-----------------------------+
|    0    |    1     |            ld_cg            |
+---------+----------+-----------------------------+
|    0    |    1     |            sd_cg            |
+---------+----------+-----------------------------+
|    0    |    1     |          addiw_cg           |
+---------+----------+-----------------------------+
|    0    |    1     |          slliw_cg           |
+---------+----------+-----------------------------+
|    0    |    1     |          srliw_cg           |
+---------+----------+-----------------------------+
|    0    |    1     |          sraiw_cg           |
+---------+----------+-----------------------------+
|    0    |    1     |           addw_cg           |
+---------+----------+-----------------------------+
|    0    |    1     |           subw_cg           |
+---------+----------+-----------------------------+
|    0    |    1     |           sllw_cg           |
+---------+----------+-----------------------------+
|    0    |    1     |           srlw_cg           |
+---------+----------+-----------------------------+
|    0    |    1     |           sraw_cg           |
+---------+----------+-----------------------------+